################          #############
#..............############...........#
#..............|..........|...........#
#..............############...........#
################          #############
