##################################################
#,~~$$$,,,,,,,,^...,,,,,~$$$$,,,,,,,,,,,,,^,,,,,,#
#,~~~~~^^,,,,,.....,,,,$~~$$,,,,,..,,,^^,,,,,,,^$#
#,$$$~~$,,,,,,^^^..^^,^~~$,,,,,,.....,,^,,,,,,^,$#
#,,~~~~$,,,,,^.....,,,,$$,,,,,,.^..^..,,,^^,,,,$~#
#,,$$$$,,,,^,,.....,,,,$,,,,,,..^..^,,,,,,,,$$$~~#
#,,,,^,,,,,,,,,^...^^,$$,,^,.......,,,,,,,,,~~~~~#
#^^^$^,,,,,,,,,.....,,^$$,,,.....^.,,,,,,$$$$~~~$#
#,,^$$$$,,^,,,,,....,,,$~,,,,......,,,,,,$$$$~~~$#
#^,,,$$$,,,,,,^.....^,^$~$,,,,,,,...,,,,,,^,$$~$,#
#,,,,,,,,^,,,,...^.,,,$~~$$,,,,,^...,,,,,,,,$$$,,#
#,,,,,,,,,,^^,.^..^,^,~~~~$^,^,,,,,,,,,,,,,$~~$,,#
#,,,,,,,,,,,,^,....,,,$~~~~,,,,^,,,,,,^,,,,,$~~,,#
#,^,,,,,,,,,,^.....,,,,$~~~~,,,,,,,,.....,,,,$$$,#
#$$$$,,,,,,,,,,..^.,,,,$~~~~$,^,,,,.......,^,,$$,#
#~$,$$,$,,,,,,,^..,,,,,,$~~~$,,,,,,......,,,,,$$,#
#~,,,,,$$^,^,,,,,,,,,,,,,$~~$,,,,,...^.^.,,,,,,$$#
#~$,,,,,$^,,,,^,,,^^,,,,,,$$$$$,,,.......^,,,,,,,#
#$,,^,,,^,,,,,,,,,,,,,,,$$$$,$,,,.......,,,,,,^,,#
#,^,^,,,,,,,,,,,,^,,,,,,$~~,,,,,,...^..^^^,,,^,,,#
#,,,,,,,,,,,,,,,,,,,,,,$$~~$,,,,,,.^..,,,,,,$$~$,#
#.,,,,,,,,,,,,,^,,,,,,$~~~~~$,^^,,,,,..,,,,$~~~$,#
#..^,,,,,,,,,,^,,,,,,,,$~~~~,,,,,.,,,,,,^,,~~~~$$#
#......,,,^,,,,,..^,,,,,,$$$,,,,,^.,^,,,^,,$~~~~$#
#.....^.,,,,,,,,..^,,,,,,,,$,^,,....,,,,,,^^$$~~$#
#........^,,^,,,,.^,,...,,,,,,,...^.,,,,,,,,,,$$,#
#......,,..,,,^,^,,,..,,,,,,,,,......^,,,,,,,,,,^#
#.,...,,,.,,,,^,,^,..,,,^,,,,,^.....,,,,^,,^,,,,,#
#,,..,,,..,,,,,,,,,,^,,.,,,,,^.^....,,,^,,,,,,,,,#
#,,,..,,,,,,^,,,,,^,,^,,,,,,,,,,...,,^,,^,,,,,,,,#
#,,,...,,,,,,,,$$,,,,^,^,,,$,,^,,.,,,,,,,,,,,,,^,#
#^,,....,^,,,,^~~~,,,,,,,,,~$,^,,,,,,,,^,,,,,^..^#
#,,,....,,,^^,$~~~,,,^,,^,$~~$,,,,,,,,,,,,,^..^.^#
#$,,....^,,,,,$~~~$,,,,,,,$~~~$,,,,$,,,,,,,.S^...#
#~$,,...,,,,,,^$~~~,,,,,,,$~~~$^,,,,^,,,,,,^.....#
#~$,,,..,,,,,,,$~~~$,^^,,,$~~~,,,,,R,,,,^,,,....^#
#~$^,,.^,,,,,,,$~~~$^,,,,$~~$$,,,,,,,,,,,,,,..^,.#
#$,,,,,,^,,,,,,,~~~$,,,,,,$$,,,,,,,,,,,,,,,,..,,.#
#,,,,^,,,,,,,,,$~~~,,,,,,,,$^,^,,,..,,,,,,,,..,,.#
#,,,,,,,,,,,,,,~~~~,,,,,,,,,,,^,,,,..,,,,,,,.,,,,#
#,,..,,,,,,,,,,$$~~,,^,,,,,,,,,,,,,^,,^,^,,,^,,,,#
#....,,,,,,,,,,$$~$,,^,,,,,,,,,,,,,,,,,,,,,,^,,,^#
#..^,,,,,,^,,,,,$$$,,,,,,,,$,,,,^,^,,,,$$,,,,,,,,#
#....,,,,,,,,^,,,$$,,,,,,,$$$,,,,,,,,$$~~~~~~$,,,#
#.^@^,,,,,,,,,^,,$$$,,,,,,,,,,,,,,,,,,$~~~~~$,,,^#
#....,,,^,,,,,$$$$,,,,,,,,,,,,,,,,,,^,,~~~$,,,,,,#
#....,,,^,,,,,$~$,,,,,,,,,,,,,,,,.,,,,,$,,,,,,,,,#
#,^..,,,,,,.,,,$$,,,,,,,,,,,,,,^^..,,^,,,,,,^,.,,#
#^^,.^^,,^.^,,,,,^,,,,,,,^,,,,,,^..^,,,,,,,,,.^.S#
##################################################
