,,,,,,.,,,,,,,,,,,,,,.........,,,,,,,,,.,,,,,,,..,
.,,,..........,,,,,,...........,,,,,,,,,,,,,,,,...
,,,,.........,,,,,,,............,,,,,,,,,,,,,,,,,.
,,...,,......,,,..................,,,,,,,,,,,,,,,,
,,...,,.....,,,,...................,,,,,,,,,,,,,,,
,,......,,,,,,,,...................,,,,,,,,,,,,,,,
,,......,,,,,,,,...................,,,,,,,,.,,,,,.
.........,,,,,,,,...................,,,,,,..,.....
.,.......,,,,,,,,,,..........,.......,..,,,,,.....
,,,,......,,,,,,,,,....,,...,,...........,,,,.....
,,,.......,,,,,,,,,.,,,,,,,,,,,........,,,,,,.....
...........,,,,,,,,,,,,,,,,,,,,.......,,,,,,,.....
...........,,,,,,,,,,,,,,,,,,,,.......,,,,,,,,....
...........,,,,,,,,,,,,,,,,,,,,,......,,,,,,,,,...
............,,,,.,,,,,,,,,,,,,,,....,,,,,.,,,,,,,,
.............,,..,,,,,,,,,,,,,,,,,,,,,,,....,...,,
.....,,..........,,,,,,,,,,,,,,,,,,,,,,,,..,,..,,,
..,,,,,,,..........,,,,,,,,,,...,,,,,,,,,.,,,,,,,,
,,,,,,,,,...........,,,,,,,,....,,,,,,,,,,,,,,,,,.
,,,,,,,,,,,.........,,...,,,...,,,,,,,,,,,,,,,,,,.
,,,,,,,,,,,.........,,...,,,,,,,,,,,,,..,,,,,,,,,,
.,,,,,,,,,..........,,....,,,,,,,,,,,,,.......,,,,
,,,,,,,,,,.........,,,,...,,,,,,,,,,,,,.......,,,,
,,,,,,,,,,..........,,,..,,,,,,,,,,,,,,........,,,
,,,,,,,,,...........,,,,,,,,,,,,,,,,,,,,.......,,,
...,,,,,,...........,,,,,P,,,,,,,,,,,,,,.......,,,
....,,,,,...........,,,,,,,,,,,,,,,,,...........,.
......,,,............,,,,,,,,,,,,...............,.
...,,.........,,,,..,,,,,,,,,,,,...............,,,
.,,,,.........,,,,.,,,,,,,,,,,..............,..,,,
,,,,,.....,...,..,..,.,,,,,,,,,....,,...,,.,,..,,,
,,,,,,,,..,,,,,..,.....,,,,,,,....,,,,..,,,,...,,,
,,,,,,,,,,,,,,..,......,,,,,,,..,,,,,,,,,.,....,,,
,,,,,,,,,,,,,,..,.......,,,,,,.,,,,,,,.,.........,
,,,,,,,,,,,,,,,,........,,,,,,,,,,,,,,...........,
,,,,,,,,,,,,,,,........,,,,,,,,,,,,,,,....,......,
,,,,,,,,,,,,,,........,,,,,,,,,,,,....,,,,,......,
,,,,,,,,,,,,,.....,,..,,,,,,,,,,,,...,,,,,,......,
,,,,,,,,,,,......,,,,,,,,,,,,,,,,,,,,,,,,,,.......
,,,,,,,,,,......,,,,,...,,,,,,,,,,,,,,...,,.......
,,,,,,,,,,,.....,,,,,....,,,,,,,,,,,,,..,.........
.,,,,,,,,,,.....,,,,.......,,,,......,,,,,........
..,,,,,,,,,.....,,,,........,,,......,,,,,,.......
...,,,,,.,,.....,,,,,........,.......,,,,,,.......
...,,,....,....,,,,,,...............,,,,,,,.......
,.,,,.........,,,,,,,...............,,,,,.........
,,,,.........,,,,,,,,...............,,,,,.........
,,,,.........,,,,,,,...............,,,...,,.......
,,..........,,,,,,,..........,,,,,.,,....,,,,.....
,,..........,,,,,,,..........,,,,,.......,,,,,..,,
