##################################################
#,,,$,,$,,,,^,,~~$,,,....,,,,,,,,,,,$,^,^,^...,,,#
#,,,$$$~$$,,,,,~~$,,^,.....,,,$~~$,^,,^,^,.....,,#
#.,,,,~~~~$^$$$$$^,,,^,....,^,,$~$,,,,,,,,,.^....#
#^.,,,$~~~~~~~~$,,,,,,^,,^^.,,,,$$,,,,,,,,,,.....#
#..,,,,~~~~$~~~~,,^,,,,,,,,^^,^,,$,,,,,,,^,,..,,.#
#...,,,,$$$$$~~~$,,^,,,,,,,,,,,,,,,,,,,,,,,,,,,,,#
#...,,^,,,^,$~~~~$,,,^,,,,,S,,,,^,,,,,,,,,,,,,,,,#
#....,,,,,,,$~~~~$,,,,,^,,,,,,,,,,,,,,,,,,,,,,,,,#
#,...,,^,,,,$~~~$$,,,,,,,^^,,,,,,,,,,,,,,,,^,,^,,#
#,.....,,,,,,$$$$,,,,,,,,,,,,,,,,,,,,,,,^,,,,,,,,#
#,......,,,,,$$,,,,,,,.,,,,,,,,,,,,,,,,,,,,^,,,,,#
#,.^...^,,,,,$,,,,,,,,..^,,,,,^,,,,^,,,,,,,,,,^,,#
#,....^,,,,,,$,,,,,,,,,.^,,,,,,,^,,,,,,,,,,,,,,,$#
#.^...,,^,,,$$,,S,,,,,,,,,^$$,^,,,,,,^,,,,,,,,,,$#
#....R,,,,,,,,,,,,,,,,,,,,^~$,,^,,,,,,,,,,,,,,,,,#
#.....^.,^,,,,,,,,....,^^,$~$,,,,,,,,,,$,,,,,,,,,#
#,......,,,,,$$,,,,...,,,,$$,,,,,^,,,,^~$^,^,,,,,#
#,,.....,,,,,$$$$,,,,,,,,,,^,,,,,,^,^,,~,,,,,,,,^#
#,,,...,,,,,^,,,$,,,,,,,,,,,,^,,,,,^,,,,,,,,..,,,#
#,,,,.,,^,,,,,,,,^^,,,,,,,,,,,,,,,,,,,,,,,..,,,,,#
#,,,^,,..,,,,,,,,,,,,R,$~$,,,,,,,^,,,,^^,...,,,^,#
#,,,,,,,,,,,,,,,,,,,,$$$$$,,,^,,,,,^^,^,,^..^..,^#
#,,,,,^,,,,,,^,,,$~~~~$,$$,,,,,,,,,,,,^,,,,,,.^..#
#^,,,.,,,,,,,^,,$~~~~$,,,$,,,,,,,,.,..,,,^,,,....#
#,,,,..,,^,^,^,$~~~~~,,,$$$,,,,,,.....,,,,,,,....#
#,,^,..,^@^,,,$~~~~~~$$$~~~$^,,,,^...,,,,,,,,,...#
#,,,..,,,,,,,$~~~~~~~~~~~~~$,,,,^,,^.,^,,,,,,,...#
#,,...,^,,,,,~$$,,,,,$~~~~~,,,,,,,^^,,,,,,,,,,,,,#
#,...,,S,,,,$$,,,,,,^R~~$~~,,,,,,^..,,,,,,,,^,,,,#
#,...^,,,,,,$,,,,,,,,,$,,,$,,,^,,^..,,,,,,,,,,,,,#
#,,.....^,^,,,,,^..,,,,,,,,,,^^,^...,^,^,,^,,,,,^#
#,,,,,...,,,,,,,,,^,,,^,,^,,^$,,,,.......^,,,,,,,#
#,,,,,...,,,,,,,,,,,,,,^,,$$~~$,^,.......,,,,,,^,#
#,^,,,^.^......,^,,,,^,,,,~~~~~$$,,,,...^,,,,,,,,#
#$$$,,......^.,,,,,,,,,,,,~~~~~$$,,,^,...,,,,,,^,#
#~~$,,,.......,,,R,,,,,,,,~~~$$$~$,,,,,.,,^,,,,,^#
#~~$,,,.......,,,,^,^,,,,,$$,,$$~~$,,,,,,,,,,,,,^#
#,,,,,,,,.^,,,,,,^,,,,,,^,,,,,,$~~~$,,,,,,,,,,,,,#
#,,,,,^,,,,,,,^,,,,,,,,,,^,,,,,,$~~$,,,,,,,,,,,,,#
#,,^,,,,,,,,,,,,,,^,,,,,,,,,^,,^^$$,,,R,,,^,,,,^,#
#^,,,^,,,,,,,,,,^,,,^,,,,,,,,,,,,^,,,,,^,,^,,,,,,#
#,,,,S$$$$,,,,,,,,,.^,S...,,,,,,,,,,,,,,,,,,,,,,$#
#,^,,,$$$$$$$,,,,,.^.,.^^...^,,,^,,,,,,,,,^,,,,,$#
#,,,,^,,$$$$$^^,,,,..........^..,,,,,,,,,,,,,,,,,#
#,,,,,,$$$,$,,,,,,,,,^..........,,,,,,,,,,^,,,,,,#
#,,,,,,$$^,,,,,,,,,,,,..........,,,,^,,,^,,,,..,,#
#,,,,,,$,,^,^,,,,,,,,,.......^,^^,,,$$^,,,,,,..^,#
#,,,,,$$,^,,,,,,,,,,,........,,,,^,,$$,,^,,.....^#
##################################################
