##################################################
#,,^,,,,,$,,,^,,,,,,,,,,,....,,,,^,,$,,,,,,,,,,,,#
#,,,^,,,,$,,^,,,$~~$$,,,,,...,,,,,,$$,,,,,,,,,,,^#
#,,,,^,,,,,,,,,,~~~~~~,,,,^,,,,,,$$$$,,,,,,,,,,,,#
#^R,,,,^,^,,,,,,$~~~~~$,,,,,,,,,$~~~~$$,,,,,,,,,,#
#,,,,,,,,,^,,,,,,$~$$$,,,,,,^,,$~~~~~~$~~~~~$,,,,#
#,,^$S,,,,,,^,,,,,,,,,^,,,,,,,,$~~~~~~$~~~~~~$$,,#
#,$$$,,,^,,,,,,,,,,,,,,,,,,,,,,$~~~~~~~~~~~~~$$,,#
#$~~,,,,,^,,,,,^,,^,,^,,,,,,,,,,~~~~~~~$~~~~$,,,,#
#$~~$,^,,,,,,,,,,..,,,,,,,,^,,,^~~~~~$$,,,$$$,,,,#
#,$~$,,,,S,^^,,,,..,,,,,,,,,,,,,$$$$^,^,,,,,,,,,,#
#,^,,,^$$,,,,,,..,.,,,,,,^,,,,,,,,,,,,,,,,,,,,,,,#
#,,,,,,$$$,^,^^,,,^,,,,,,^,,^,,,,,,,,,,,,,,,,,,,,#
#,,,$$,,,$,,,,,,,,,^,,,,,,,,,,,,,,,,,,,@...,..,,,#
#,,$$$^,,,,,,,,,,,,,,,,,,,,,,,,,,,,,,,,^....,.,,,#
#,,$$$,^,,^,,,,,^,,,,,,,,,,,^,,,,,^,...^.^.,,,,,,#
#$~~~~$,,,,,,,,,,^,,,,,^,,,,,,,,...^..^...S^,,,,,#
#~~~~~$,,,,,,,,,,,,,,^,,,,,,,,,,............,,,^^#
#~~~~~~$,^,,,,,,,,,,,,,,,^,,,,,,,.......,,,,,,,,^#
#,$^$~~~,,,,,,,,,,,,,,,,^,^^,,,,,^.....,,,,,,,,,,#
#,,,,$~$,,,,,,,,,,,,,^,,,,^,,,,,,,,...^,,,,,,,,,,#
#,,,,,~$,,,,^,,,,,,,,,,,,,,,^,,,,,,,,.^,,^,^,,^,,#
#,,,,,^,,,,,,,,$,,,^,,,,,,,,,,,,,,,,,,,,^$$,,,,,$#
#,,,,,,,^^,,,,,,,$,,,^,^,,,,,,,,,,,,,,,,,$~$$$,,$#
#,,,,,,,,,,,,,,,,$$,,,,,^,,,,,,,,S,,,,,^$~~~~~$,,#
#,,,,,,,,,,R,,,,,$~~$,,,,,,,,,,,,,,,,,,,,~~~~~$$,#
#^,,^,,,^,,,,,,,,$~~~$,,,,,,,,,,,,,,,,,,,$~~~~~~~#
#^,,,,,^,,,,,,,,,,^$$,^^,^,,,$$$$,,,,,,,,$~~~~$$~#
#,,,,$,,,^,,,,,,,,^,,^,,,,,,^,,^,,^,,,,,,,$~~~,,$#
#,,,$$^,,^,,,,,,,,,,,,,,,,^,^^^,,,,,^,,,^,,$$,,,,#
#,,,^,^,,,,,,^,,,,,,,,,,,,..,,,,,,^,,,,,,,,,,^,,,#
#^,$,,,,,,,,^,,,,,,,,,,,,^..,,,,^,,,,,,^,,^^,$$,,#
#$~~$$$$,,,,,^,^,,^,,,,,,..,,,,,,,,,^^,,,,,,,,,,,#
#~~~~~~~$$,,,,,,,,,,,,,,,,,,^,,,^R,,,,,,^,,,,,,,,#
#~~~~~~~~~$,^,,,,,,,,,,,,R^^,,,,,^,,,,^,,,,^^,,,,#
#~~~~~$~~~~,,,,,,,,,,,,,,,,,,,,,,,^,,,,,,,,,,,,,,#
#~~~~,,,$~$$$$$$$,,,^,,,,^,,,,,,^,,,,,,,,^,,,,,,,#
#$~$,,,,,$$,$~~~,,,,,^,,,^,,,,,,,,,^,,,,,,,,^,,,,#
#,,,^,,,,,,,$~~,,,,^,^,,,,,,,,,.,,,,,,,,,,,,^^,,,#
#^,,,,,,,,,,$~$,,,,,,,$$$,,,,,,,^,,,,,,,,,,,,,,,,#
#,,,,,,,,,,,$$,,,,,,,,,$$$,,,,,,,,,^^^,,,,,,.,,,^#
#,,,,,,,,,^,,,,,,,,,,^,,$$,^,,,,,,,,,,,,,,,,...,,#
#,,,^,,,,,,^,,,,^,,,,,^,,,,$$$,,,,,,,,,,,........#
#,,,,,,,,,,,,,,,...,,,,^,,,$$~$,,^,,,,,^....^....#
#,,^,,,,,,,,,,^.^^.^.S,,,,^,,$$,,,,^,,,......^...#
#,,,,,,,,^^.,,,........,,,,,,,,,,,,,^,,,.^.......#
#,,,,,,,^.^.,^^.^..,....,,,,,,,,,,,,,,,,..^..,,,^#
#,^^$,,,,...,.....,,,...,,,,,,,,,,,,,,,,^...^,,,,#
#,,,$$,,,......,,,,,,,,,,,,,,,,,,,,,^^,,..,,,,,,R#
##################################################
