##################################################
#,~,,,,,,,,,,,,....,,,~~~~~~^,,,,,....,,,,,,,,,,,#
#,,,,,,,..,,,,.....,,,~~~~~~,,,,,,...,,,,,,~~~~~,#
#,,,,,,,...,,,.....,^,~~~~~~,,^,,,..,,,,,,^~~~~~~#
#,,,^^,,...,,^.....,,^^~~~~,,,,,,,,,,,,,,,,~~~~~~#
#,,,,,,,....,.......,,,~~~~,,,,,,,,,,,^,,,,~~~~~,#
#,^~,,,,.,,.........,,,~~~~~,,^^,,^,^,,,,^,~~~~~,#
#,,,,^,,,,,,.......,,,,~~~~~,,,,,,,,,,^,,~~,,~~~,#
#,,^,,^,,,,,,,.....,,,,~~~~~,,,,,^,.,^,,,~,,~~~~~#
#,,,,,,,^,,,,,,...,,,,,~~~~~,,,,,^...,^,,,,,~~~~~#
#,,,,~~,,,,,,,,..,,,,,,~~~~,,,,^,,....^,,,,,,~~~~#
#,,,,~~~,,,,^,...,,,,,,~~~~,,^,,^,,,,.,,,,,,,,~~~#
#,,,~~~,,,,,,,..,^^,^,,,,~~,,,,,,,,,..,^,,^,,,,~~#
#,,,,~^,,,,,,,..,,,,,,,,,,~,,,,,,^,,,,,,..,,,,,,~#
#,,,,,,~^,,^....,,,,,,,,^~~~,,,,,,,,,,,,,^,,,,^~~#
#,,,,,,,^,,,..,..,,,,,,,,~~~,,,,,,,,,,,,,,,,,^,~~#
#,,,,,,^,,,,,,R...,,,^,,,~~~~^,,,,,,,,,,,,,,,,^~~#
#,,,^,,,,,,,,,.....,,,,,~~~~~,,,,^,,,,,,,,,,,,,,,#
#,^^,,..,,,,^,,....,,,,~~~~~~,,,,,^^,,,,,,,,,,,,,#
#,,,,,...,,^,,,,,...,,,~~~~~~,,,,,,,,,,,,,,,,,,,,#
#,,,^....,,,,,,,,^.,,,,~^~~~,,,,,,,,,,,,,,,,,,,,,#
#,,,,....,,,,,,,,,,,,,,,,,,,,,,,,^^,,,,,,,,,,,,,,#
#,,,,,,.,,,,,,,,,,,^^,,,,,,,,,,,^,,,,,,,,^,,,,,,,#
#,,,,,,^,,,,,,,,,,,,,,,,,,,,^,^,,,,,,^,,,,,^,,,,,#
#.,,....,,,,,,,,,,,,,,,,,,,,,,^,,,,,,,^,,,,,,,...#
#.......,,,,,,,,,^,,,,,,,,^,,,^,~~~,,,,,,,,,,....#
#.......,,,^^,,,,,,,,,..,,,^,,,,~~~~,,,,,,,,^,...#
#.......,,^,,,~~,,,,,,..,,,,,^,,,~~~,,,,,,,,,,...#
#^.....,,,,,,,~~,,,,^,...,,,,,,,,~~,,,,,,^,,,,...#
#,....,,,,,,,~~~,,,,,,@..,,,,,,,,,,,,,,,,,,^,,...#
#,....,^,,,,,~~~,,,,,,...,,,,,,^,,,,,,,,^,,,,....#
#,,...,,,,,,,,~~,,,,,,,,,^,,,,,,^,,,,,,,,,,.....,#
#,,..,,,^~,,,,~~~,~,,,,^^,,,,,^,,,,,,,,,,,,....,,#
#,,,.,,,,,,,,,^~~,,,,^,,,,,,,,....^,,,,,,,,...,^,#
#,^,,,,^^,,,,,,,,,,,^,,,...,,......,.,,,,,,..,,,,#
#,,,,,,,,,,,,^,,,^,,,,^,.,,,,.........,,,,,S,,,,,#
#,^,,,,,,,,,,,,,,,,,,,,,,,,,,.........,,,,,,^,,^,#
#,,,,,,,,,,,,,,,^,,,,,,,,,,,,^^........,^,,,,,,^,#
#,,,,,^,,,,^,,...,,,^,,,,^,,^,,,,,,....,,,,,,,^,,#
#,,,,,,^,,,,,,....,,^,,^,,,,,,,,,,,,...,,,,^,,,,,#
#,,,,~,,,,,,^,,....,,,,,,,,,,,,^,,,,...,,,,,,,,,,#
#,,,~~~~,,,,,,.....,,,,,,,,~~,,,,,,,....,,,,,,,,,#
#,,~~~~~,,,,,......,,,,^,,,~,,,,,,,,,...^,,,,,^,,#
#~~~~~~~~^,,,,....,,,,,,,,,,,,,,,,,,,,,^,,,..^,,,#
#~~~~~~~~~~,,,,,.,,,,..,,,,,,,,,^,,,,,,,,.....,,,#
#~~,,~~~~~~,,,,,,,,,,^,,,,,,^,,,,,,,,,,,,......,,#
#,,,~~~~~~~,,,,,,,,,,,,,,,,,,,,,,,,~,,,,,,....,,,#
#^,,~~~~~~~,,,,,,,,^,,,,.,,,,,,^,,~~~~,,,,....,,,#
#,,,,,~~~,,,,,,,,,,,,,,..,,..,,,,~~~~~,,,,....,,,#
##################################################
