##################################################
#,~,,,,,,,,,,,,....,,,~~~~~~^,,,,,....,,,,,,,,,,,#
#,,,,,,,..,,,,.....,,,~~~~~~,,,,,,...,,,,,,~~~~~,#
#,,,,,,,...,,,.....,^,~~~~~~,,^,,,..,,,,,,^~~~~~~#
#,,,^^,,...,,^.....,,^^~~~~,,,,,,,,,,,,,,,,~~~~~~#
#,,,,,,,....,.......,,,~~~~,,,,,,,,,,,S,,,,~~~~~,#
#,^~,,,,.,,.........,,,~~~~~,,^^,,^,^,,,,^,~~~~~,#
#^,,,^,,,,,,.......,,,,~~~~~,,,,,,,,,,^,,~~,,~~~,#
#,,^,,^,,,,,,,.....,,,,~~~~~,,,,,^,.,^,,,~,,~~~~~#
#,,,,^,,^,,,,,,...,,,,,~~~~~,,,,,^...,^,,,,,~~~~~#
#,,,,~~,,,,,,,,..,,,,,,~~~~,,,,^,,....^,,,,,,~~~~#
#,,,,~~~,,,,^,...,,,,,,~~~~,,^,,^,,,,.,,,,,,,,~~~#
#,,,~~~,,,,,,,..,^^,^,,,,~~,,,,,,,,,..,^,,^,,,,~~#
#,,,,~^,,,,,,,..,,,,,,,,,,~,,,,,,^,,,,,,..,,,,,,~#
#,,,,,,~^,,^....,,,,,,,,^~~~,,,,,,,,,,,,,^,,,,^~~#
#,,,,,,,^,,,..,..,,,,,,,,~~~,,,,,,,,,,,,,,,,,^,~~#
#,,,,,,^,,^,,,R...,,,^,,,~~~~^,,,,,,,,,,,,,,,,^~~#
#,,,^,,,,,,,,,.....,,,,,~~~~~,,,,^,,,,,,,,,,,,,,,#
#,^^,,..,,,,^,,....,,,,~~~~~~,,,,,^^,,,,,,,,,,,,,#
#,,,,,...,,^,,,,,...,,,~~~~~~,,,,,,,,,,,,,,,,,,,,#
#,,,^....,,,,,,,,S.,,,,~^~~~,,,,,,,,,,,,,,,,,,,,,#
#,,,,....,,,,,,,,,,,,^,,,,,,,,,,,S^,,,,,,,,,,,,,,#
#,,,,,,.,,,,,,,,,,,^^,,,,,,,,,,,^,,,,,,,,^,,,,,,,#
#,,,,,,^,,,,,,,,,,,,,,,,,,,,^,^,,,,,,^,,,,,^,,,,,#
#.,,....,,,,,,,,,,,,,,,,,,,,,,^,,,,,,,^,,,,,,,...#
#.......,,,,,,,,,^,,,,,,,,^,,,^,~~~,,,,,,,,,,....#
#.......,,,^^,,,,,,,,,..,,,^,,,,~~~~,,,,,,,,^,...#
#.......,,^,,,~~,,,,,,..,,,,,^,,,~~~,,,,,,,,,,...#
#^.....,,,,,,,~~,,,,^,...,,,,,,,,~~,,,,,,^,,,,...#
#,....,,,,,,,~~~,,,,,,@..,,,,,,,,,,,,,,,,,,^,,...#
#,..S.,^,,,,,~~~,,,,,,...,,,,,,^,,,,,,,,^,,,,....#
#,,...,,,,,,,,~~,,,,,,,,,^,,,,,,^,,,,,,,,,,.....,#
#,,..,,,^~,,,,~~~,~,,,,^^,,,,,^,,,,,,,,,,,,....,,#
#,^,.,,,,,,,,,^~~,,,,^,,,,,,,,....^,,,,,,,,...,^,#
#,^,,,,^^,,,,,,,,,,,^,,,...,,......,.,,,,,,..,,,,#
#,,,,,,,,,,,,^,,,^,,,,^,.,,,,.........,,,,,R,,,,,#
#,^,,,,,,,,,,,,,,,,,,,,,,,,,,.........,,,,,,^,,^,#
#,,,,,,,,,,,,,,,^,,,,,,,,,,,,^^........,^,,,,,,^,#
#,,,,,^,,,,^,,...,,,^,,,,^,,^,,,,,,....,,,,,,,^,,#
#,,,,,,^,,,,,,S...,,^,,^,,,,,,,,,,,,...,,,,R,,,,,#
#,,,,~,,,,,,R,,....,,,,,,,,,,,,^,,,,...,,,,,,,,,,#
#,,,~~~~,,,,,,.....,,,,,,,,~~,,,,,,,....,,,,,,,,,#
#,,~~~~~,,,,,......,,,,R,,,~,,,,,,,,,...^,,,,,^,,#
#~~~~~~~~^,,,,....,,,,,,,,,,,,,,,,,,,,,^,,,..^,,,#
#~~~~~~~~~~,,,,,.,^,,..,,,,,,,,,^,,,,,,,,.....,,,#
#~~,,~~~~~~,,,,,,,,,,^,,,,,,^,,,,,,,,,,,,......,,#
#,,,~~~~~~~,,,,,,,,,,,,,,,,,,,,,,,,~,,,,,,....,,,#
#^,,~~~~~~~,,,,,,,,^,,,,.,,,,,,^,,~~~~,,,,....,,,#
#,,,,,~~~,,,,,,,,,,,,,,..,,..,,,,~~~~~,,,,....,,,#
##################################################
