##################################################
#~~~$~$,,,,,,,,,,,,,,,,,$$$,,^,,,,$~~~~,,,,,,,,,,#
#~~~~~$,,,,,^,,,,,,,,,,,$$$,,,,,,^$~~~~,,,,,,,,,,#
#~~~~~$,,,,,,,,,,,,,,,,^$$^,,^,,,,$~~~~,^,,,,,,,,#
#~~~~~$,^,,,,,,.,,,,,,,,$$,,,^^,,,,~~~~,^,^,,,,,,#
#~~~~~$,,,,,,,,,^,,,,,,,,,,,,^,,,^,$~~~,,,,,,,,,,#
#~~~~~$,,,,,,,,,,^,,,,,,,,,,,,,,,,^,$~$,,,^,,,,,,#
#,~~~~~$,,,,,,,,,,,,,^,,,,,,,,,^^,,^$$,,,,,,,,,,,#
#,$~~~~~^,,^,,,,,^,,,,,,,,^,,,,^,,,,$^,,,,,,,,,,,#
#,$$$~~~^,,,,,,..,,,,,,^^,,,,,,,^,,~~,,,,,,,^,,,,#
#,,,,$~~,^,,^^^.^.,,,,,,^^,^,,,,,,$~~$,,,^,^S.,,,#
#,,,,$$$,,^,,,^.^.,,,,,,,,,,,,,,,$$$$$,,,,,,,.,^,#
#,,,,,,,,,,,,,,,.,,,,,,,,,,,,,^$$,$$$$,,,,,,,,.,,#
#,,,,,,,$^,,,^,^,,,,,,,^,,,,,,,,,,$$$$,,,,,,,^.^,#
#.,,,,,,~$,,,^,,,@,,,,,,,,,,,,,^^,,,$,,,,,,....,,#
#.,,,,,,$~~,,$$,,^,,,,^,,,$$~$^,,,,,$,,,,,^^...^,#
#.,,,,,,$~~$$~~$,,,,,,,,,,,$~$,,,,,,$$,,,,,,,..^,#
#,,,,,,,,,,$$~~~$,,,,,,,,,,$$,,,,,,,,,,,,^,,,,..,#
#^,,,S,^,,^$~~~$$,,,,,,,,,,$~,,,,,,,,,,,,,,^,,.,,#
#,,,,,,^,,,,~~~$$,^,,,,,,,^$~$,,,,,,,,,,,,,,,,.,,#
#^,,,^^,,,,,,~~$,,,,,,,,,,,,$,^^,,,,,,^,,,,,,..,,#
#^,^,,,^,,,,,$,,,,,,,,,,,,,,^,,,,,,,,,,^,,,,....,#
#,,,,,,^,,,,,,,,,,,,,,^,,,,,,,^,^,^,,,,^,,,,...^,#
#$$,,,,^^,,,,,,^,,,,,,,,,,,,,,,,^,,,,,,,,,,..^^,,#
#$,,^,,,,,,...,^,,,,,,,,,^,,,,,^,,,,$~$,,,.....^.#
#,,^,,,,,,,....,,,,.....^,^...,,^,,,$~~$,,,......#
#,,,,,,,......,,,,,.....,,....,,,,,,$~~~$,,....^^#
#,,,,,^,,....^^,,,,.....,,,^,,,,^,,,,$$$,,,......#
#,..,S,,,,,,.,,,,,,,.....,,,^,,,,,^,,$$,,,,,....^#
#,,,,,,^,,,,..,,,,,,,,...,,^,,,,,,,,,,^,,,,,.....#
#,,,,,,,,,,,.^,^,,,,,,,,,,,^^,,,,^,,,,,,,,,,,....#
#,^,,,,$$,^,,,,,^,,,,,,,,,,,,,^,,,,,^,,,,,,,,^...#
#,,,^,R$~$,,,,,,,,,,,^,,,,,,,,,R,,,,,^,,,,^,,...,#
#,,,,,,$$$$,,^,,S,S,,,,^,,,,,,^,,^,,,,,,^,^,,...,#
#,^,$$,^$~~,,,^,,,,,,,,,,,^,,,^,,,,,^,,,,,,,,...,#
#,^,,,,$~~$,,^^,,,,,^,,,,^,,,,^,,,,,.^.,..,.....,#
#,,,$$,$$,,,,,,,,,,,^,,,$$$$,,,,,R^....,........,#
#^,,~~$,^,,,^,,..,,,,,,,,~~~$,,,,,,^...,,,,....,,#
#,,$~~$,^,,,,,,..,,,,,,,,~~~,,^,,^,,..,,,,,^..^,^#
#,,$~$,,,,,,,.R,,,^,,,,,,$~~$,,,,,,,,,,^,^,...,^,#
#R,~~$,,,,,,,,,,,,,,,,,,,$~$$,,,,,,,,,,,^,,...^,,#
#,,$~$,,,,,^,,,,,,,,,,,,,~~,,,,,,,,^,,,,,,,,^,,,,#
#,,,$$,,,,,,,,,,,,,,,,,,$~$,,,,.,,^,,,,,,,,,^,,,,#
#,,,$$,,,,,,,,,,,,,,,,,$$$$$,,,^,,,^,,,$,^,,,,,,,#
#,,^$$^,,,,,^,,,,,,,$$$$$$,,,,,.^^,,,,$~$,,^,,,$$#
#$^$$$$,,,,,,,^,,,,,$$$$,,,,,,,,,,,,,$~~$^,,,,~~$#
#$$$$$$$^,,^,,,,,,,^,,,,,,,,,,,,,,,,$~~~$,,$$$~~~#
#~$$$$$$,,,,,,,,,,,,,,,,,,,,,,^,,,$,$~$^,,,$$~~~~#
#~~$$,,,,,,,,,,^,^,,,,,,,.,,,,,,,,~$,,^,,,,^~~~~$#
##################################################
