################          #############
#..............############...........#
#...P..........|..........|...........#
#..............############...........#
################          #############
