##################################################
#,...,,,,,,,,^$~~~$,,,,,...,^,,,,$$,,,,,,....,,,,#
#,.....,,,,,,,$~~~~,,,,,,,,^,,,,,$,,,,^,,,.,,^,,,#
#,,.....,,,,,,,~~~~~$,,,,,,,,,,,,$,,,,,,,,,,,,,,,#
#,,,^....,,,,,,$~~~~~,,,,^,,,,,,$~$,,,^,,,,,,^,,^#
#,,,,,,^.,,.,,^,~~~~$,,^,,,,,,,,$~$,^,,,,,,,,,,,$#
#,,,^,,,,^...,,,,$$$,,,,,^,,,,,,$$$^,,,,,,,,,,^,~#
#,,,,,,,,,...,^,^,^,,,,^.,^,,,,,$$,,,,,,,^,,,,^,$#
#,,,,,,,^^,,,,,,,,,,,,,..,,,,,^,,,^$$,$$,^,^,,,,,#
#,,,,,,^,,,,,,,,,,,,,,,..,^,,,,,,,,,,,,,,,,,,,,^,#
#^,,,,^,,,,,,,,,,,,,,,...,,,,^,,,,,,,,^,,,.,,,,,,#
#,..,,,,,,,^,,,,,,,^,,.^.,,,,,,,,,,,,,^,,^.,,,,,,#
#.^.,^,,@,,,,$~,,,,,^^....,,,,,,,,,,,,,S...^.....#
#..,,,,,,,,,$~~,,,,,,,.....,,,,,^,,,^^,,...^.^...#
#^,,,,,,,,$~~~~^R,,^^,,,,,,,,,,...^,,,,,.........#
#,,.^,,^,,~~~~~,,,,,,,,,,,,,^,.....,,,,,,...^....#
#,,..,,,,^$~~~~,,,,,,,,,,,,,^,.^...,^,,,,........#
#....,,,,^^~~$^,,,^,,,,,,^,,,,.....,,,^,,,......^#
#,....,,^,,,,,^,,,^,,^,,,,,^,,...^,,,,,,,,,......#
#.....,,^,^,,,,,,,^,,,,^^,,,,^,,,^,,,,,,,,,......#
#.....,,,,,^,,,,,,^,,,,,,,,,,^,,,,,,,,,,,,,.^....#
#,....,,,,R,,,,,,,,,,,,,$$$,,,,,,,,,,,,,,,^^.....#
#,.....,,,,,,,,,,,,^,^,^$$~~$,,,^,,,,,,,,,......,#
#,......^,,,,,...^,,,^,,^$~~~$$,,,,,,,,,^,,.....,#
#,..^...,,,^,,^.....,,,,,$~~~~~,,,,,,,,,,,,,....,#
#.....,,,,,,,,..,,...,,,,$~~~~$,,,,,,^,,,,,,.^..,#
#..^,,,,,,,,,,,,,,...,,,,$~~~~$,,,,,,,,,,,,,,...,#
#..,,,,^,,,,,,,,..,,,,,,,$~~~~$,^,,,,,,,,,,,,..,,#
#.,,,,,,,,,,,,,,,,,,,,,,,$~~$,,,,,,,,,,^,,,,,..,,#
#,,^,^,,,,,^^,,,,,,,,,,$,$~$,,,,,,,,^,,^,,,^,,.,,#
#,,,,,,,,,,,,.....,,,,$$$$~$,,,,,,,,,,,,,,,,,,,,,#
#,,,,^,^,,,,,...^..,^,,$~~~$,,,,,,^,,,,,,,^,..,,,#
#,S,^,^^,,^,,......,^,,~~~~$,,,,^,,^,,,^,,,..,,,,#
#,^,,,,,,,,,,....,,,,,,~~,,,,,^,,^,^$$$,,,,..,,^,#
#,,,,,,,,,,,,...^,,,,^,,,,,,,,,,^,,,,,,,,,,..,,,,#
#,,.,..,,,,,,,,^,,,,,,,,,,,,,,,,,,,,,,,,,^,..,,^,#
#,,.^...,,,,,,,,,^,.^.,,,,,,,,,,,^,,,,,,,,.S..^.,#
#,^......,,,,,,,R,,.....,,.,,,,,,,^,^,,,,........#
#^,..^,,..,,,^,,,,,..,^.,,.,,^,,,,$,,,,,,....,,,,#
#,.....,,,,,$,,,,,,,,,,.,,,,,,^,,,,,^,,^,,^,,,,,,#
#,......,,,$$$,,,,,,,,,,,,,,,,,,,,,$$,^,,^,,,,,,,#
#,......,,,$~$$$$,,,,,,,,,,,,,,,,^^~~$,,,^,,,,,,,#
#,,......,,$~~$$$,,,$$,,,,,,,,,^,,,$~~~~~~,,^,,,,#
#^,,.....,,,$,,,$$,,$$,,,,,,,..,,,,$~~~~~~$,,,^,,#
#,^,,....,,,,,,,,,,,,,,,,,,.....,,,$~~~~~~,,,,$$,#
#$,,,,^.^.,,,,,,,,,,,,,,,,,..^..,,,$~~~~~$,,,,,,,#
#$,,^,,....,,,^,,,^,,,,,,,,......,,,$~~$$,,^,,,,,#
#,,^^,,.....,,,,,^,,,,^,,,,.^..,,,^,,^,,,,,,,^,,,#
#,^,,^,^....,,,,,,,,,,,,,,,.^,,,,,,,,,,,,S,,,,,,S#
##################################################
