##################################################
#,~~~~~^,,,^,,,,,,~,,,,..,,,,,,^~~~~~~~,,,,...,.^#
#,,,,,,,^,,,,,^,,,~~,,,,,,,,,,^,,~~~~~,,,,,^.,,,,#
#,,,^,,,,,,,,,,,,,~~~~,,,^,,,,,,,~~~~~~,,,,^,.,,,#
#,,,S,,,,,,,,,,,,,~~~~,,,~~^,,,,,~~~~~~,,,,,,,,,,#
#,,,,,,,,,,,,,,,,,^~~,,,,,~,,,,,,,,~~~~,,,,,,,,,,#
#,,,,,,,,,,,,,,,,,,,~,,,,,,,,,^,,,,,~~~,,,,^,,,,,#
#^,,,,,,,,,,,,,,,,,,,^,,,~~,,,,,,,,,,,,,,,,,,,,,,#
#^,,,,,,,,,,,^,,^^^,,,,,~~~~,,,,,^,,,,,,^,,,,.,,^#
#,,,,,,,,,,,,,.,,,,,,,,^~~~^^^,,^,,,,,,,,,^,...,^#
#,,,,,,,,,^,....^,,,,^,,,~~,,^,,,,,,,,,,,,,....,,#
#,,,,,,,,,,,,...,,,,,,,,,,,,,,,,^,,,,,,,,^^......#
#,,,,,,,,,^,,,.,,,,^^^,,^^,,,,,,,,,,,,,^,,....^..#
#,,,,,,,,,,,^,,,,,,,,^,,,,,,,~~~,,,,,,,,,,,,,,...#
#,,,,,,,~~,,,,^,,,,,,^^,,,,,,~~~,,,,,,,,,........#
#,,,,,,~~~~,,,,,,,,,^,,,^,,,,^,,,,,,,,,,,^......,#
#,,,^^~~~~~,,,,,,,^,,,,,,,,,,,,,,,,,,,,,,.^,,,^,,#
#,,,,,,,~~~,,,,,^,,,,,,^,^,,,,,,~~,~,^^,...,,,,,^#
#,,,^,,,~~,,^,,,,,,^,,,,,,,,,,,~~~~~,,,,^.,,,,,,R#
#,,,,,,,,,,,,,,,,,,,,,,,,,,,,,,,~~~,,,,,,,,,,,,,,#
#,,,,^,,,^,,,,,,,,,,,,,,.,,,,,,,~~~,,,,^,,,^,,,,,#
#,,,,,,,^,,,,,,,,,,,,,,,,,,,^,,,,~~~,,,,,,,,,^,..#
#,,,,^,,,,,,^,.^,^,^,,,,,,,,..,,,~~~~,,,,,,,,,...#
#,,,,,,^,,......,,,,,,,,,,,...,,,,,,,,,,,,,^,...,#
#,,^,,,,.....^...,^,,,,,,....,,,,,,,,,,,,,,^...,,#
#,,,,,,,,^...^.,,,^,,,,.,,...^,,,,,,,,,,,,,,.,,,.#
#,,,,,^,,...^.,,,,,,,....,,..,,,,,,,,,,,,,,,,,,,.#
#,,,,,,^,...,,,,,^,,,..^..,..,,,,,,,,..,,,,,^,,,,#
#,,,,,,,,...,,^,,,,,,,,,,^,,,,,,,^,.,,,,^,,,^,,,^#
#^,,,~,,,,,,,,,^,,,,,,,,,,,,,,,,,,^,,,^,,,,,,,,,,#
#,,,,~,,,,,,^,,^,^,^,,,,,,,,,,^,,^,,,,,,,,,,,,,,,#
#,^,~~~~~,,,,,,,,,^,,,,,,,,,,,,^,,,,,,,,^,,^,,^,^#
#^,,~~~~~~,,~^^,,,^,^,,,^,,^,,^,,,,,,,,,,,,^,,,^,#
#,^,~~~~~~~~,,,,,,,,,,,,,,,,,,,,,,,,,^,,~~,,,^,,,#
#,,,,,~~~~,,,,,,,,,,,,,,,,,,,,,,,,,^,,,,,,,,,,,,,#
#,,,,,,~~,^,,,^,,,^,,,,,,,,,,,^,,,,,,,,,,,,,,^,^,#
#,,,,,,,,,,,,,,,^,,,,,,,,,,~~,,,,,,,,,,,^,,,,,^,,#
#~,,,,,,,,,,,,~~,,,,,,,,,~~~~~~^,~,,,,,,,,,,,..,^#
#~,,,,,,,,,,,~~~,,,,,,,,,~~~~~~,,~^,,,,,,,,,,.S.,#
#,,,,,,,,^,,,,,,,,,,^,,,,,,,,,,,,,,,,,,^,,,,^,..,#
#,,,^,,,^,,^,,,,,,,,,,,^,,,,,,,,,,,^,,,,,,^,,,,,,#
#,,,,^,,,,,,,,,,,,,,,,^,,,,,,,,,,,,,,,,,,,,,,,,,,#
#,,,,,,,,,,,,,,,,,,,,,^,,,,^,,,,,,,,,,,,,,,,,,,,,#
#,,,,,,,.,,,^,,,,,,,,,,,,,,^,,,R,,,,,,,,~~,,,,,,,#
#,...,,^,,,,,,,,,,,,^,^,,,,,,,,,^,,,,,,,~~,,,^,~~#
#....^,.,,,,,,,,,,,,,,^,,,^,,,,,,,,,~~,,,^,,,,,~~#
#..^.....,,,,,,,,,^^,,,^,,,^,,,,,,,~~~^,,,,^,~~~~#
#......^.,,^,,,,,,,,,,,,,,,,,,,,,,,,~,,,,,^,~~~~,#
#.,...^,,,,^,,,,,,,^,,,,,,,,,,,,,,,,,,,,,,,,,^,,@#
##################################################
